#####################
#           #     # #
# # ####### # # # # #
# # #   #   # # #   #
# ### # ### ### ### #
#     #   #     # # #
# ####### ####### # #
#     # #   #   #   #
##### # ### # # ### #
# #   #   #   #   # #
# # ##### ####### # #
# #       #     # # #
# ####### ### # # ###
#       #     # #   #
# ####### ######### #
# #   #   #         #
# # # # ### ####### #
#   #     # #       #
# ######### # #######
#     #S    #      E#
#####################
