#####################
#   #         #     #
# # # ####### ### # #
# #   #     #     # #
# ##### # ######### #
#   # # #   #       #
# # # # ### # #######
# # #   # # #       #
# # ### # # ####### #
# #   # # # #       #
##### # # # # #######
#     #   #   #   # #
# # ##### ##### # # #
# #E#   #       # # #
# ### # ######### # #
#     #   #     # # #
# ####### # ### # # #
# #     # #   #     #
# ### # # ######### #
#     # #        S# #
#####################
